{
    "level_name":"Example #8",
    "level_creator":"dozaaa",
    "level_tags":[
       "loop"
    ],
    "block_placement":[
        [2, 2, 2, 2, 2, 2, 2, 2, 2, 2, 2, 2, 2],
        [2, 1, 1, 1, 1, 1, 1, 1, 1, 1, 1, 1, 2],
        [2, 1, 1, 1, 1, 1, 1, 1, 1, 1, 1, 1, 2],
        [2, 1, 1, 1, 1, 1, 1, 1, 1, 1, 1, 1, 2],
        [2, 1, 1, 1, 1, 1, 1, 1, 1, 1, 1, 1, 2],
        [2, 1, 1, 1, 1, 1, 1, 1, 1, 1, 1, 1, 2],
        [2, 1, 1, 1, 1, 1, 1, 1, 1, 1, 1, 1, 2],
        [2, 1, 1, 1, 1, 1, 17, 18, 1, 4, 1, 1, 2],
        [2, 1, 1, 1, 1, 1, 1, 1, 1, 1, 4, 1, 2],
        [2, 1, 1, 1, 1, 1, 1, 1, 1, 1, 1, 1, 2],
        [2, 1, 1, 1, 1, 1, 1, 1, 1, 1, 1, 1, 2],
        [2, 1, 1, 1, 1, 1, 1, 1, 1, 1, 1, 1, 2],
        [2, 1, 1, 1, 1, 1, 3, 1, 1, 1, 11, 1, 2],
        [2, 1, 1, 1, 1, 1, 1, 1, 1, 1, 1, 1, 2],
        [2, 2, 2, 2, 2, 2, 2, 2, 2, 2, 2, 2, 2]
    ],
    "block_additional_data":[],
    "snake_data":[
        {"name": "snake2", "type": 0, "color": "green", "placement": [[6, 3], [6, 4], [6, 5]], "direction": "S"},
        {"name": "snake1", "type": 0, "color": "green", "placement": [[1, 7], [2, 7]], "direction": "E"}
    ],
    "available_blocks":[[3, 1], [5, 2], [8, 2]]
}